x;y;1
7.680;10.977;-1;
14.976;9.441;-1;
8.832;10.752;0;
10.368;9.216;-1;
12.672;8.673;0;
3.456;14.049;-1;
5.760;14.049;-1;
12.672;0.768;-1;
15.360;7.680;-1;
0.000;4.608;-1;
4.224;1.761;-1;
8.064;5.601;-1;
14.208;11.520;-1;
13.824;5.376;-1;
0.768;7.137;-1;
1.152;2.304;-1;
1.152;13.056;-1;
15.360;2.304;-1;
11.136;13.281;-1;
