x;y;1
3.840;3.297;-1;
14.976;4.608;-1;
13.824;4.065;-1;
0.000;12.288;-1;
5.760;11.745;-1;
1.536;13.824;-1;
10.368;4.833;-1;
1.152;2.304;-1;
1.536;10.752;-1;
