x;y;1
14.208;6.144;-1;
1.152;3.072;-1;
14.592;1.761;-1;
10.752;1.761;-1;
13.824;12.288;-1;
8.832;6.369;-1;
4.608;6.144;-1;
11.136;14.592;-1;
13.440;10.752;-1;
