x;y;1
12.672;10.752;-1;
9.600;0.225;-1;
0.384;7.680;-1;
13.440;5.376;-1;
6.912;1.761;-1;
15.360;0.768;-1;
11.136;13.824;-1;
14.976;4.065;-1;
13.824;0.225;-1;
