x;y;1
6.144;2.304;-1;
5.376;5.376;-1;
3.840;0.993;-1;
10.752;13.281;-1;
12.288;9.216;-1;
10.752;8.448;-1;
14.976;11.745;-1;
11.904;4.065;-1;
10.368;1.761;-1;
