x;y;1
12.672;2.304;0;
11.904;0.993;-1;
11.136;8.448;-1;
13.824;2.304;-1;
7.296;1.761;-1;
12.672;11.520;-1;
13.440;9.441;-1;
8.832;9.984;-1;
15.360;10.209;-1;
