x;y;1
11.904;0.993;-1;
4.224;5.601;-1;
10.368;10.209;-1;
5.760;14.049;-1;
5.760;9.984;-1;
8.448;14.049;-1;
10.368;0.000;-1;
13.440;10.977;-1;
14.976;9.984;-1;
