x;y;1
13.440;12.513;-1;
15.360;13.056;-1;
3.456;13.056;-1;
10.368;3.297;-1;
1.920;4.065;-1;
1.152;10.209;-1;
9.216;0.993;-1;
13.056;5.601;-1;
0.768;6.144;-1;
