x;y;1
1.536;14.592;-1;
3.072;14.592;-1;
3.456;0.768;-1;
1.536;0.768;-1;
8.064;0.993;-1;
13.056;13.824;-1;
13.440;15.360;-1;
1.536;13.281;-1;
6.144;1.536;-1;
