x;y;1
11.136;12.513;-1;
9.216;10.977;-1;
4.224;14.049;-1;
6.144;12.288;-1;
6.144;13.824;0;
5.376;0.993;-1;
11.136;14.817;-1;
1.536;6.912;-1;
15.360;4.608;-1;
15.360;7.137;-1;
4.992;6.912;-1;
1.536;10.977;-1;
2.688;15.360;-1;
13.440;3.072;-1;
10.368;9.216;-1;
0.000;3.297;-1;
14.976;13.056;-1;
13.440;10.752;-1;
