x;y;1
3.840;6.144;-1;
9.984;7.137;0;
11.136;5.601;-1;
8.064;8.673;-1;
9.984;9.441;-1;
4.224;4.833;0;
13.056;8.448;-1;
1.920;8.448;-1;
12.672;10.752;-1;
12.672;2.304;-1;
0.768;7.905;-1;
5.760;11.745;-1;
14.208;5.601;-1;
1.536;0.993;-1;
13.056;13.824;-1;
15.360;11.745;-1;
3.840;3.072;-1;
1.152;11.745;-1;
