x;y;1
13.824;15.360;-1;
11.136;0.225;-1;
11.136;10.977;-1;
0.384;7.680;-1;
4.224;7.680;-1;
14.976;7.680;-1;
8.832;3.072;-1;
1.536;4.065;-1;
1.920;14.817;-1;
1.152;9.216;-1;
