x;y;1
12.288;8.673;-1;
3.840;0.768;-1;
12.288;11.745;-1;
14.592;14.049;-1;
14.208;3.840;-1;
9.984;12.288;-1;
8.832;6.912;-1;
11.136;1.536;-1;
10.368;8.448;-1;
0.384;3.840;-1;
