x;y;1
9.984;10.752;-1;
11.136;11.745;0;
11.520;9.984;-1;
13.824;15.360;-1;
10.752;14.592;-1;
1.152;0.993;-1;
9.984;5.376;-1;
5.376;13.056;-1;
4.992;14.817;-1;
3.456;10.209;-1;
1.536;8.448;-1;
8.064;3.297;-1;
14.976;9.216;-1;
6.912;0.225;-1;
1.536;3.297;-1;
1.152;6.912;-1;
15.360;14.592;-1;
