x;y;1
14.208;14.817;-1;
15.360;3.297;-1;
6.528;0.768;-1;
9.984;13.281;-1;
14.592;10.752;-1;
13.440;4.065;-1;
13.824;1.536;-1;
1.152;15.360;-1;
1.152;14.049;-1;
8.064;13.824;-1;
12.288;10.752;-1;
3.840;8.448;-1;
5.760;3.072;-1;
12.672;8.673;-1;
14.976;0.768;-1;
8.064;6.369;-1;
8.832;9.984;-1;
