x;y;1
5.760;1.761;0;
6.912;2.304;-1;
14.976;0.000;-1;
1.536;9.984;-1;
1.920;2.529;-1;
10.368;6.144;-1;
8.448;14.817;-1;
14.592;1.536;-1;
12.288;0.225;-1;
2.688;8.673;-1;
13.056;15.360;-1;
1.536;3.840;-1;
4.992;5.376;-1;
14.208;11.745;-1;
11.520;7.905;-1;
10.368;13.281;-1;
3.072;0.000;-1;
15.360;7.680;-1;
14.976;13.824;-1;
2.688;11.745;-1;
