x;y;1
9.216;9.441;-1;
11.520;4.833;0;
7.680;13.824;-1;
13.824;12.513;0;
12.288;6.144;-1;
11.904;10.977;-1;
6.528;0.000;-1;
14.976;2.529;-1;
14.592;10.977;-1;
11.904;2.304;-1;
4.608;12.288;-1;
14.208;15.360;-1;
8.832;4.608;-1;
11.136;0.000;-1;
1.920;11.745;-1;
1.536;13.824;-1;
11.520;13.824;-1;
8.064;15.360;-1;
7.296;9.984;-1;
4.608;4.833;-1;
