x;y;1
12.672;10.752;-1;
10.752;0.225;-1;
1.920;8.673;-1;
0.000;7.905;-1;
12.672;8.448;-1;
5.760;13.056;-1;
1.920;4.608;-1;
11.520;5.376;-1;
