x;y;1
14.208;6.144;-1;
7.296;14.817;-1;
10.752;4.608;-1;
9.600;11.745;-1;
4.608;11.520;-1;
1.536;13.056;-1;
11.136;6.369;-1;
14.976;14.592;-1;
