x;y;1
11.520;9.441;-1;
3.456;0.000;-1;
1.920;9.984;-1;
8.832;3.297;-1;
11.520;15.360;-1;
0.768;7.905;-1;
10.368;4.065;-1;
10.368;10.752;-1;
