x;y;1
9.984;6.912;0;
11.520;7.137;-1;
3.840;6.369;-1;
11.136;0.225;-1;
5.760;4.065;-1;
11.136;9.216;-1;
10.368;12.513;-1;
12.672;2.529;-1;
1.920;0.225;-1;
0.384;5.376;-1;
13.440;0.768;-1;
8.448;6.144;-1;
