x;y;1
14.592;7.680;-1;
13.440;8.673;0;
2.304;0.768;-1;
3.072;9.216;-1;
1.152;8.448;-1;
13.056;4.608;-1;
2.304;4.608;-1;
10.368;8.673;-1;
14.208;5.601;-1;
6.912;8.673;-1;
1.152;2.304;-1;
14.208;9.984;-1;
