x;y;1
1.152;0.993;-1;
1.152;5.376;-1;
11.520;10.977;-1;
0.000;6.144;-1;
11.520;4.833;-1;
2.688;10.209;-1;
1.152;12.288;-1;
6.144;13.281;-1;
10.368;3.072;-1;
1.536;15.360;-1;
9.984;10.977;-1;
3.072;11.745;-1;
