x;y;1
1.920;12.513;-1;
14.976;5.376;-1;
13.056;10.977;-1;
9.984;13.281;-1;
15.360;13.824;-1;
3.840;9.216;-1;
7.296;12.513;-1;
15.360;3.072;-1;
1.536;2.304;-1;
7.680;4.608;-1;
5.376;12.513;-1;
13.056;4.833;-1;
1.920;8.448;-1;
4.224;0.000;-1;
10.368;3.840;-1;
7.296;7.137;-1;
