x;y;1
12.672;5.601;-1;
12.288;6.912;0;
13.056;8.673;-1;
13.824;13.281;0;
12.672;2.304;-1;
15.360;4.608;-1;
14.976;1.761;-1;
5.376;9.441;-1;
1.536;14.049;-1;
10.752;9.441;-1;
2.304;12.288;-1;
12.672;13.824;-1;
4.224;9.984;-1;
0.768;10.209;-1;
4.608;3.840;-1;
14.976;12.288;-1;
