x;y;1
13.440;0.000;-1;
12.288;0.000;-1;
14.592;11.520;-1;
12.288;5.376;-1;
1.152;4.833;-1;
