x;y;1
13.824;3.297;-1;
1.152;3.840;-1;
10.368;8.673;-1;
12.288;13.056;-1;
14.208;12.513;-1;
