x;y;1
14.976;4.608;-1;
14.208;0.225;-1;
13.824;10.752;-1;
6.528;7.137;-1;
10.752;5.601;-1;
13.824;14.817;-1;
