x;y;1
11.520;10.977;-1;
11.904;1.536;0;
8.064;8.673;0;
13.056;13.056;-1;
12.672;11.520;0;
10.752;8.448;-1;
12.288;3.840;-1;
11.904;0.225;-1;
6.912;9.441;-1;
4.224;3.297;-1;
3.072;2.304;0;
2.688;14.817;-1;
1.536;1.536;-1;
3.456;0.000;-1;
8.448;11.745;-1;
14.208;4.065;-1;
1.152;8.448;-1;
13.056;15.360;-1;
6.528;1.761;-1;
14.208;0.000;-1;
13.824;6.912;-1;
6.144;14.592;-1;
