x;y;1
4.224;0.768;-1;
3.072;0.993;0;
14.592;0.993;-1;
2.688;8.448;-1;
3.840;13.824;-1;
0.768;4.608;-1;
0.384;6.144;-1;
12.288;13.281;-1;
14.208;3.840;-1;
13.440;7.680;-1;
1.152;12.288;-1;
14.976;13.281;-1;
9.600;5.376;-1;
13.056;1.761;-1;
8.064;13.056;-1;
13.056;9.441;-1;
7.296;0.225;-1;
1.152;10.977;-1;
3.456;6.144;-1;
10.752;11.520;-1;
1.536;0.000;-1;
7.680;15.360;-1;
