x;y;1
0.384;7.680;-1;
10.752;11.745;-1;
0.384;4.833;-1;
12.288;7.137;-1;
15.360;13.281;-1;
11.904;0.000;-1;
1.920;1.761;-1;
11.136;1.536;-1;
11.136;5.376;-1;
14.976;10.977;-1;
3.456;0.225;-1;
14.592;6.144;-1;
0.000;12.513;-1;
4.608;1.761;-1;
1.152;11.745;-1;
