x;y;1
8.448;13.281;-1;
7.296;13.824;0;
2.688;14.817;-1;
8.064;4.833;-1;
1.536;9.441;-1;
13.824;7.680;-1;
13.824;14.592;-1;
12.288;10.752;-1;
11.136;7.905;-1;
0.000;13.056;-1;
6.144;3.840;-1;
6.144;12.513;-1;
11.520;3.072;-1;
13.440;4.608;-1;
15.360;6.144;-1;
