x;y;1
13.056;12.288;-1;
1.920;10.977;-1;
12.288;0.000;-1;
15.360;13.281;-1;
12.672;10.209;-1;
5.376;0.000;-1;
9.984;10.209;-1;
10.752;3.840;-1;
0.000;7.137;-1;
14.592;3.297;-1;
7.680;0.768;-1;
6.144;13.056;-1;
14.592;8.673;-1;
12.288;6.144;-1;
13.440;0.768;-1;
