x;y;1
13.824;8.673;0;
5.376;0.993;-1;
6.912;3.072;-1;
11.520;8.673;-1;
14.976;8.448;-1;
6.144;15.360;-1;
10.752;12.288;-1;
6.144;13.281;-1;
1.920;8.673;-1;
12.288;15.360;-1;
13.056;3.297;-1;
10.368;15.360;-1;
11.520;5.376;-1;
0.384;6.912;-1;
1.920;13.056;-1;
