x;y;1
10.368;9.441;-1;
1.920;3.297;-1;
12.288;9.984;0;
13.440;9.216;-1;
0.768;6.369;0;
1.152;4.833;-1;
8.832;0.225;-1;
6.144;14.049;-1;
12.288;0.768;-1;
14.592;14.817;-1;
0.768;7.905;-1;
1.920;10.752;-1;
2.688;15.360;-1;
8.064;9.441;-1;
1.536;0.768;-1;
13.440;3.297;-1;
11.136;12.288;-1;
3.456;0.225;-1;
13.824;6.912;-1;
4.608;6.369;-1;
11.520;5.376;-1;
