x;y;1
11.520;10.752;-1;
7.296;12.288;-1;
8.064;10.977;0;
8.832;7.905;-1;
11.520;7.905;-1;
5.760;14.592;0;
4.608;14.817;-1;
13.824;1.761;-1;
6.912;8.448;-1;
0.384;4.833;-1;
12.288;0.000;-1;
14.592;12.288;-1;
0.000;15.360;-1;
14.976;9.216;-1;
11.136;13.824;-1;
13.824;4.608;-1;
9.600;0.768;-1;
13.440;13.824;-1;
0.384;10.209;-1;
1.536;13.281;-1;
11.520;3.072;-1;
