x;y;1
3.072;4.065;0;
14.976;8.673;-1;
4.224;5.376;-1;
1.152;14.592;-1;
8.448;0.225;-1;
1.920;0.993;-1;
4.608;8.673;-1;
1.536;12.288;-1;
10.368;5.601;-1;
1.536;4.065;-1;
6.912;8.673;-1;
12.288;4.608;-1;
0.000;12.513;-1;
