x;y;1
14.208;9.441;0;
13.056;8.448;-1;
10.752;14.049;-1;
1.536;6.912;-1;
13.056;4.065;-1;
10.752;9.441;-1;
1.536;12.513;-1;
9.600;5.376;-1;
7.296;1.761;-1;
3.840;11.745;-1;
14.208;10.977;-1;
12.288;3.072;-1;
3.456;14.817;-1;
