x;y;1
13.056;7.137;-1;
2.304;8.448;-1;
1.920;12.513;-1;
8.064;7.137;-1;
8.448;11.745;-1;
7.296;1.536;-1;
1.152;6.144;-1;
4.992;14.592;-1;
13.056;14.049;-1;
11.136;7.905;-1;
15.360;10.752;-1;
8.448;3.840;-1;
10.368;10.752;-1;
