x;y;1
13.824;10.209;-1;
14.208;14.817;-1;
4.224;4.065;-1;
9.216;11.745;-1;
12.288;1.761;-1;
2.304;3.072;-1;
4.992;10.977;-1;
3.840;8.448;-1;
13.056;13.056;-1;
1.920;1.761;-1;
13.056;3.297;-1;
13.440;0.225;-1;
5.376;14.592;-1;
