x;y;1
5.376;7.905;0;
6.528;10.209;-1;
14.976;5.376;-1;
12.672;1.761;-1;
11.904;0.000;-1;
4.992;6.912;-1;
14.592;11.520;-1;
12.288;13.281;-1;
8.448;1.761;-1;
13.440;10.977;-1;
4.224;15.360;-1;
3.072;10.977;-1;
12.672;3.840;-1;
