x;y;1
1.536;1.536;-1;
7.680;2.529;-1;
11.520;14.049;-1;
1.920;4.065;-1;
4.992;7.137;-1;
14.976;10.977;-1;
4.224;0.225;-1;
15.360;5.376;-1;
13.056;13.824;-1;
4.608;14.817;-1;
12.672;8.448;-1;
13.440;9.984;-1;
9.216;13.056;-1;
4.608;9.441;-1;
