x;y;1
5.376;1.761;-1;
3.072;5.601;-1;
15.360;1.536;-1;
13.440;2.304;-1;
10.368;6.144;-1;
14.208;3.840;-1;
12.288;9.216;-1;
4.992;10.977;-1;
14.976;6.912;-1;
10.368;8.448;-1;
1.152;10.977;-1;
0.384;0.768;-1;
3.072;1.536;-1;
4.992;4.608;-1;
