x;y;1
6.528;13.824;-1;
1.536;14.592;-1;
1.920;3.840;-1;
3.840;14.592;-1;
14.976;14.817;-1;
10.752;9.216;-1;
10.368;14.049;-1;
3.840;3.072;-1;
13.056;9.216;-1;
1.152;4.833;-1;
3.840;12.513;-1;
