x;y;1
4.608;5.601;-1;
14.976;0.000;-1;
5.760;7.137;-1;
6.912;10.977;-1;
12.288;2.304;-1;
14.208;12.288;-1;
14.208;14.592;-1;
13.056;13.824;-1;
15.360;8.673;-1;
9.600;3.297;-1;
1.152;11.745;-1;
