x;y;1
1.536;1.536;-1;
11.136;3.297;-1;
0.000;9.216;-1;
13.824;4.608;-1;
1.536;13.824;-1;
0.768;12.513;-1;
6.528;4.833;-1;
1.920;6.912;-1;
11.904;9.984;-1;
5.376;0.225;-1;
5.376;4.608;-1;
